4	4	4	4	4	4	4	4	4	4	4	4	4	4	4	4	4	4	4	4	4	4	4	4	4	4	4	4	4	4
4	1	0	0	0	4	3	3	3	0	0	4	4	4	0	0	0	4	0	0	0	0	0	0	4	4	0	2	0	4
4	4	4	0	0	4	3	3	3	0	0	0	0	0	0	0	0	4	0	0	0	4	0	0	0	4	0	0	0	4
4	5	5	0	0	4	3	3	3	4	0	0	0	0	0	0	0	4	0	0	0	4	0	0	0	4	4	4	0	4
4	5	5	0	0	4	3	3	3	4	0	0	0	0	0	0	0	4	0	0	0	4	0	0	0	4	0	0	0	4
4	0	0	0	0	4	3	3	3	4	0	0	0	4	0	0	0	4	0	0	0	4	0	0	0	4	0	0	0	4
4	0	0	0	4	4	4	4	4	4	0	0	0	4	0	0	0	4	0	0	0	4	0	0	0	4	0	0	0	4
4	0	0	0	4	0	0	0	0	4	0	0	0	4	0	0	0	4	0	0	0	4	0	0	0	4	0	0	0	4
4	0	0	0	4	0	0	0	0	4	0	0	0	4	0	0	0	4	0	0	0	4	0	0	0	4	0	0	0	4
4	0	0	0	4	0	0	0	0	4	0	0	0	4	0	0	0	4	0	0	0	4	0	0	0	4	0	0	0	4
4	0	0	0	4	0	0	0	4	4	0	0	0	4	0	0	0	4	0	0	0	4	0	0	0	4	0	0	0	4
4	0	0	0	4	0	0	0	4	0	0	0	0	4	0	0	0	4	0	0	0	4	0	0	0	4	0	0	0	4
4	0	0	0	4	0	0	0	4	0	0	0	0	4	0	0	0	4	0	0	0	4	0	0	0	4	0	0	0	4
4	0	0	0	4	0	0	0	4	0	0	0	0	4	0	0	0	4	0	0	0	4	0	0	0	4	0	0	0	4
4	0	0	0	4	0	0	0	4	0	0	0	4	4	0	0	0	4	0	0	0	4	0	0	0	0	0	0	0	4
4	0	0	0	4	0	0	0	4	0	0	0	4	0	0	0	0	4	0	0	0	4	0	0	0	0	0	0	0	4
4	0	0	0	4	0	0	0	4	3	0	3	4	0	0	0	0	4	0	0	0	4	0	0	0	0	0	0	0	4
4	0	0	0	4	0	0	0	4	3	0	3	4	0	0	0	0	4	0	0	0	4	0	0	0	4	0	0	0	4
4	0	0	0	4	0	0	0	4	3	0	3	4	0	0	0	4	4	0	0	0	4	4	4	4	4	0	0	0	4
4	0	0	0	4	0	0	0	4	0	0	0	4	0	0	0	0	0	0	0	0	4	3	3	3	4	0	0	0	4
4	0	0	0	4	0	0	0	4	0	0	0	4	0	0	0	0	0	0	0	0	4	3	3	3	4	0	0	0	4
4	0	0	0	4	0	0	0	4	0	0	0	4	0	0	0	0	0	0	0	0	4	3	3	3	4	0	0	0	4
4	0	0	0	4	0	0	0	4	0	0	0	4	0	0	0	4	0	0	0	4	4	0	0	0	4	0	0	0	4
4	0	0	0	4	0	0	0	4	0	0	0	4	0	0	0	4	0	0	0	4	0	0	0	0	4	0	0	0	4
4	0	0	0	4	0	0	0	4	0	0	0	4	0	0	0	4	0	0	0	4	0	0	0	0	4	0	0	0	4
4	0	0	0	4	0	0	0	4	0	0	0	4	0	0	0	4	0	0	0	4	0	0	0	0	4	0	0	0	4
4	0	0	0	4	0	0	0	4	0	0	0	4	0	0	0	4	0	0	0	4	0	0	0	4	4	0	0	0	4
4	0	0	0	4	0	0	0	4	0	0	0	4	0	0	0	4	0	0	0	4	0	0	0	4	0	0	0	0	4
4	0	0	0	4	0	0	0	0	0	0	0	4	0	0	0	4	0	0	0	4	0	0	0	4	0	0	0	0	4
4	0	0	0	4	0	0	0	0	0	0	0	4	0	0	0	4	0	0	0	4	0	0	0	4	0	0	0	0	4
4	0	0	0	4	0	0	0	4	0	0	0	4	0	0	0	4	0	0	0	4	0	0	0	4	0	0	0	4	4
4	0	0	0	4	0	0	0	4	4	4	4	4	0	0	0	4	0	0	0	4	0	0	0	4	0	0	0	0	4
4	0	0	0	4	0	0	0	4	5	5	5	4	0	0	0	4	0	0	0	4	0	0	0	4	0	0	0	0	4
4	0	0	0	4	0	0	0	4	5	5	5	4	0	0	0	4	0	0	0	4	0	0	0	4	0	0	0	0	4
4	0	0	0	4	0	0	0	4	5	5	5	4	0	0	0	4	0	0	0	4	0	0	0	4	0	0	0	0	4
4	0	0	0	4	3	3	3	4	0	0	0	4	0	0	0	4	0	0	0	4	0	0	0	4	0	0	0	0	4
4	0	0	0	4	3	3	3	4	0	0	0	0	0	0	0	4	5	5	5	4	0	0	0	4	0	0	0	0	4
4	0	0	0	4	3	3	3	4	0	0	0	0	0	0	0	4	5	5	5	4	0	0	0	0	0	0	0	0	4
4	0	0	0	4	3	3	3	4	0	0	0	0	0	0	0	4	5	5	5	4	0	0	0	0	0	0	0	0	4
4	4	4	4	4	4	4	4	4	4	4	4	4	4	4	4	4	4	4	4	4	4	4	4	4	4	4	4	4	4